Jonnein mekaniikan peruslaki: dynamiikan peruslaki f=ma
Jonnein kreikkalainen aakkonen: α
Jonnein W-lan-tukiasema: D-Link DIR-635
Jonnein kahvinkeitin: Mocca Master
Jonnein pöytäroolipelijärjestelmä: GURPS
Jonnein sävel: E
Jonnein kolmisointu: Am
Jonnein yhtye: Slipknot
Jonnein länsimaisen taidemusiikin aikakausi: Galantti tyyli
Jonnein planeetta: Merkurius
Jonnein aavikko: Kalahari
Jonnein nuuskamerkki: General
Jonnein uskonto: Islam
Jonnein presidentin etunimi: Risto
Jonnein monarkia: Ruotsi
Jonnein valuuttajärjestö: IMF
Jonnein pörssi: Helsingin pörssi
Jonnein työnimike: Toimitusjohtaja
Jonnein selkärangaton: Sukkulamato
Jonnein sävy: fuksia
Jonnein VST: zeta+
Jonnein pakkaus: Tetra-Pak
Jonnein sointukulku: I-IV-VII-III-VI-II-V-I
Jonnein ase Ultima Underworld II:ssa: Servicable shortsword
Jonnein vihollinen S.T.A.L.K.E.R.-pelisarjassa: Dwarf
Jonnein moderaattori: Sukkero
Jonnein etunimi: Jonne
Jonnein pylväs: Doorilainen pylväs
Jonnein arkkitehtuurinen teos, jossa hyödynnetään kultaista leikkausta: Parthenon
Jonnein esihistoriallinen keksintö: Kampa
Jonnein hentaimanga: Sei So Tsui Dan Sha
Jonnein freeware-softasyntetisaattori: Tal U-No-62
Jonnein katu Espoon Leppävaarassa: Konstaapelinkatu
Jonnein vanhempi: Äiti
Jonnein pinta-alan yksikkö: Aari
Jonnein veitsisarja: Nikkei
Jonnein kieli: maori
Jonnein planeetta: Jupiter
Jonnein puu: Koivu
Jonnein eläin: Kameli
Jonnein vuodenaika: Syksy
Jonnein säätila: Sade
Jonnein kieli: Viro
Jonnein sairaus: vesirokko
Jonnein koenumero: 6
Jonnein sukunimi: Korhonen
Jonnein julkaisija: WSOY
Jonnein elintarvikeväri: E128
Jonnein renessanssin yleisnero: Leon Battista Alberti
Jonnein juures: palsternakka
Jonnein bratislavalainen raitiovaunupysäkki: Botanická zahrada
Jonnein temppeliritarien suurmestari: Gérard de Ridefort
Jonnein koti: Omakotitalo
Jonnein planeetta: Mars
Jonnein tähtikuvio: Otava
Jonnein horoskooppimerkki: Neitsyt
Jonnein vessapaperi: Serla
Jonnein viina: Sisu
Jonnein kirjain: D
Jonnein ihonväri: Valkoinen
Jonnein meri: Itämeri
Jonnein jonne: Naapurin Jaska
Jonnein syöpä: Keuhkosyöpä
Jonnein kyläkauppa: Keskisen kyläkauppa
Jonnein astia: Tynnyri
Jonnein teippi: Kaksipuolinen läpinäkyvä teippi
Jonnein alkuaine: Rauta
Jonnein istuin: Pianojakkara
Jonnein nukkumistyyli: Vapaaputoaja
Jonnein kävelynopeus: 6km/h
Jonnein kirjain: S
Jonnein yhteenlasku: 5+2
Jonnein paikka: Satama
Jonnein nukkumismäärä: 9h
Jonnein lyijykynän kovuusaste: HB
Jonnein yleiskastike: HB
Jonnein Pyöreän pöydän ritari: sir Gawaine
Jonnein Itämeren kala: kampela
Jonnein Chopinin nocturno: cis-molli opus 48.
Jonnein hammas: 32
Jonnein natsimystiikkaan liittyvä asia: Armanenschaft
Jonnein sävel Arvo Pärtin Spiegel Im Spiegel -teoksessa: F
Jonnein tagi html:ssä:
Jonnein sivu ala-asteen matematiikankirjoissa: Sisällysluettelo
Jonnein ihmissyöntiä harjoittanut Uusi-Guinealaiskansa: Fore
Jonnein efekti Photoshopissa: Lens Flare
Jonnein musiikin teorian termi: Dominanttisuus
Jonnein elävä fossiili: Irimotenkissa
Jonnein Kreikan saari: Rhodos
Jonnein Japanin saari: Okinawa
Jonnein Apassi -johtaja: Geronimo
Jonnein intiaaniheimo: cherokee
Jonnein konkistadori: Quesada
Jonnein 1400-luvun paavi: Aleksanteri VI
Jonnein alkuluku: 17
Jonnein täydellinen luku: 6
Jonnein tähti Ison Koiran tähdistössä: Sirius
Jonnein pituusyksikkö: Megametri
Jonnein Venäjän tsaari: Nikolai II
Jonnein kivi: graniitti
Jonnein pitsa: frutti di mare
Jonnein porno: pehmoporno
Jonnein olut: foster's
Jonnein peruna: Timo
Jonnein margariinin rasvaprosentti: 80
Jonnein vilja: vehnä
Jonnein liha: naudan ulkofile
Jonnein kala: tuore lohi
Jonnein säilyke: kidneypavut
Jonnein mauste: mustapippuri
Jonnein riisi: riisikaurasekoitus
Jonnein pakaste: herne-maissi-paprika
jonnein meemu: spurdospora
jonnein nimi : jonne
Jonnein juusto: Emmental
Jonnein pullo: 50cl lasipullo
Jonnein pokemon: Charizard
Jonnein koodauskieli: Python
Jonnein biisi Divine Interventionilta: Dittohead
Jonnein Fallout 3 perk: Iron Guts
Jonnein ääntä syntetisoiva soitin: Mellotron.
Jonnein Linux Distro: Ubuntu
Jonnein tietokoneohjelma: Rocketdock
Jonnein tiedostomuoto: .mkv
Jonneimmat mitat pianolle: 132x155x67
Jonneimmat kuulokkeet: Creative Fatal1ty
Jonnein 80-luvun suksimerkki: Peltonen
Jonnein Icewind Dale- loot: yeti pelt
Jonnein kuulosuojain: Peltor
Jonnein torniojokilaaksolainen paikka: Pello
Jonnein jääkiekkoilija: Ville Peltonen
Jonnein kattomateriaali: pelti
Jonnein ympäristötyyppi: pelto
Jonnein Aku Ankan autoa kuvaava ilmaisu: peltilehmä
Jonnein sukupuoli: Mies
Jonnein ammatti: Poliisi
Jonnein kitkakerroin: 0.37
Jonnein sähkömagneettinen säteily: infrapunasäteily
Jonnein paineen yksikkö: pascal
Jonnein rahayksikkö: dollari
Jonnein ilmailu- ja avaruustekniikan instituutti: Instituto Nacional de Técnica Aeroespacial
Jonnein esisokraattinen filosofi: Protagoras
Jonnein protestanttinen kirkkorakennus: Elisabethenkirche
Jonnein entinen virolainen kirjailija: Luule Viilma
Jonnein entinen saksalainen tutkimusmatkailija: Friedrich von Gebler
Jonnein venäläinen jääkiekkoseura: HK Krylja Sovetov Moskova
Jonnein vuosiluku: 666
Jonnein Länsi-Göötanmaalla sijaitseva kaupunki: Trollhättan
Jonnein saksalainen heavy metal -yhtye: Die Apokalyptischen Reiter
Jonnein suola: Kalsiumkloridi (CaCl2)
Jonnein tietokonepeli: MechWarrior 2: 31st Century Combat
Jonnein maantiepyöräilyn ammattilaistalli: Footon-Servetto
Jonnein moottorisahamerkki: stihl
Jonnein huulirasva: dermosil
Jonneimmat farkut: micmac
Jonnein maa-aines: moreeni
Jonnein luottokorttiyhtiö.: Japan Credit Bureau
Jonnein Romanian piirikunta: Caras-Severin
Jonnein sivilisaatio: Sumer
Jonnein ioniyhdiste: Natriumvetysulfaatti
Jonnein puhallinsoitin: Aloke
Jonnein Saamelaisten kansallispuku: Gakti
Jonnein Täpläperhonen: Rämekylmänperhonen
Jonneimmat nisäkkäät: Jänikset ja kaniinit
Jonnein kansa: Krimin tataarit
Jonnein kaksisirkkainen kasvi: Canellales
Jonnein palkittu nigerialainen kirjailija: Chimamanda Ngozi Adichie
Jonnein bakteeri: Yersinia pestis
Jonnein syöksylaskia: Jean-Luc Crétier
Jonnein perhonen: Sulokaposiipi
Jonnein valtatie: Valtatie 10
Jonnein uutiskanava: Fox News Channel
Jonnein mies ikinä: Oscar Wilde
Jonnein soitin : ugulelel
Jonnein adverbi: eilen
Jonein kengänkoko: 40
Jonnein rakennsuelementti: Tiili
Jonnein Ulkoisten tekijöiden aiheuttamat mutaatiot: Nitrosoguanidiini (NTG)
Jonnein scifi: Star Wars -sarja
Jonnein bunkbändi: My Chemical Romance
Jonnein välimatka 2km
Jonnein puu: Lehmus
Jonnein maku: Umami
Jonnein mauste: Korianteri
Jonnein ideologia: Liberalismi
Jonnein neuvostojohtaja: Lavrenti Berija
Jonnein marja: Lakka
Jonnein hillo: Puolukkahillo
Jonnein kroatialainen entinen koripalloilija: Toni Kukoc
Jonnein havaitsemiseen perustuva keino havainnoida ympäristöään: Sähköaisti
Jonnein neuvostoliittolaistyyppinen Volgoneft-luokan jokitankkilaiva: Volgoneft-147
Jonnein aavikko: Iso Victorian aavikko
Jonnein juoma juoma-automaatista: Mustikkakeitto
Jonnein kenkämerkki: Reebok
Jonnein Bionicle: Lehvak-kal
Jonnein modeemi: Tp-Link
Jonnein silmälasimerkki: Ray ban
Jonnein georgialainen ruhtinas: Guaram I
Jonnein paksupääperhoslaji: Heinähiipijä
Jonnein atolli Marshallinsaarilla, Tyynellä valtamerellä: Nadikdik
Jonnein kymmenottelija: Mikko Halvari
Jonnein fysiikan nobelisti: Albert Abraham Michelson
Jonnein ajanjakso: Toinen sortokausi
Jonnein kemiallinen yhdiste: Argonfluorihydridi(HArF)
Jonnein peli: Dota 2
